tropical = {}
arid = {}
arctic = {}

mild_winter = {
	918 299 921 1859 256 888 283 920 919 2728 2528 1016 2959 895 259 2480 2035 2477 31 2988 2971 2999 2624 424
    2482 2483 27 1776 873 1930 181 2488 2573 869 996 29 2574 36 2537 294 54 2230 4021 856 4085 2622 680 280 421
    2749 35 2692 997 2575 34 287 300 607 771 2408 1958 467 2406 298 159 151 343 1764 2986 2405 763 2962 382 396
    1826 125 124 337 336 2732 2462 268 139 2099 272 335 163 2468 762 21 164 1943 2690 748 4051 2154 4039 121 320
    847 963 2262 365 2320 2647 153 4043 2577 1770 2568 985 2897 4022 4025 1200 751 2886 4023 2784 1852 1850 82
    1242 2509 2540 934 929 896 892 2960 1161 91 764 584 1042 522 1047 2122 676 2132 678 1831 118 2606 2611 363
    2539 897 1866 2975 2515 2532 2514 2407 1841 262 2538 930 1057 2527 2729 891 255 92 90 258 331 330 2704 753
    418 407 1090 2373 324 327 317 98 1846 1056 2306 2305 332 2730 2303 316 377 378 417 2731 422 2412 285 2963
    2411 257 2478 2502 2995 2997 2510 161 2006 99 291 160 157 1742 2620 2424 724 2615 411 1231 1132 2250 2319
    1951 1878 2008 909 279 2508 1936 2505 261 2378 2998 2007 866 2490 1935 348 270 39 40 156 162 657 658 2317
    2501 2504 1809 1940 2491 2973 876 867 1953 141 2493 1203 1318 2212 95 1856 2409 2308 56 879 344 2389 635
    2464 342 334 1942 5 10 2982 340 2463 72 2385 1945 1944 302 292 994 981 884 1849 93 2458 370 1997 2188 116
    260 277 1937 269 276 41 2579 2571 2582 2578 983 1947 552 848 629 2774 1855 4024 1248 2381 1796 1085 2107
    495 1195 571 4028 2599 2698 1084 587 675 2800 975 1050 2078 2061 602 1789 497 498 155 2609 1029 2210 1775
    4032 4094 2160 2243 690 2593 2023 1234 2951 496 2723 1147 2724 2775 2668 2617 855 772 426 55
    740 644 1990 1107 2737 2321 575 2798 333 2327 462 2696 2746 2204 2203 2215 15 286 2205 414 2213 2619 2614
    1238 100 2827 2750 3000 2217 1931 413 1765 325 326 328 2299 1864 2976 254 908 2383 875 1766 2495 2312 853
    907 878 1925 1854 154 1067 266 2240 2238 1113 1145 2700 4130 654 2498 864 863 243 1027 2384 2382 2316 625
    2274 2268 986 1133 2272 722 2115 695 1838 2143 696 2141 2564 2566 1162 2295 2256 362 1233 148 628 364 379
    2133 583 616 2166 636 1185 2928 2930 2072 2797 1078 2441 2438 491 2429 661 615 2630 2401 745 2396 1043 673
    1829 900 2179 665 2181 128 1816 2370 444 441 2362 449 455 445 2068 438 1973 1076 478 514 2699 2627 381 136
    547 2031 512 2073 1075 2428 538 2357 479 2358 2366 2354 2359 456 576 2361 1967 476 2227 2787 2289 4103 832
    4100 4068 1767 4109 2796 4059 4054 4069 4070 4044 4062 774 2324 4057 4099 2162 4106 2909 825 4104 4102 322
    2169 4089 2003 4088 4096 4095 4107 936 4078 4079 1164 1165 2173 1166 2163 1191 2913 4098 2063 4105 1183 1177
    1174 2856 4042 688 672 1171 4081 4087 2949 798 1170 1167 4121 2434 1754 2898 2917 4036 2915 4040 4046 4037
    765 4034 4045 4047 4091 4093 710 4092 868 4090 4108 1229 2864 2489 1175 749 2088 2916 2778 2818 2885 142 429
    2294 4080 1169 1168 1151 2067 2177 1216 4060 4082 1172 2948 2156 4084 694 2766 2762 2927 1901 4083 314 1957
    1759 2572 543 2457 4116 4048 4031 183 750 1199 1194 1792 548 1197 2824 4049 754 752 2922 4038 4035 4020 4110
    188 17 4123 2467 2460 30 4115 2447 32 980 33 273 2101 2032 962 2459 265 1863 132 592 311 189 236 238 219 1860
    2529 70 1071 1848 4122 275 24 149 4125 893 4117 481 1882 2751 698 701 235 351 94 4129 123 126 2984 2155 1246
    430 3003 2219 152 1773 408 140 1205 2644 2629 3002 1032 1758 2536 2546 146 147 705 1853 2972 2512 2616 2499
    2399 865 2506 931 26 1985 4 81 2648 2628 940 2691 371 2646 2645 138 2874 226 222 143 1827 2925 1982 2469 339
    2541 927 935 2520 2466 158 7 223 434 1204 2130 135 877 1954 2736 2899 1747 2004 2596 2535 22 2005 627 783 634
    793 805 809 811 1097 1099 1100 1201 1214 1252 1253 1254 1255 1256 1257 1259 1263 1264 1265 1306 1258 1266
    1267 1271 1277 1282 1802 1807 1810 1994 1991 2200 1934 1950 3190
	#1.25
	4323 4324 4325 4326 4327 4328 4329 4330 4331 4332 4333
	4348 4349 4350 4351 4352 4353 4354 4355 4488 4366
	4444 4445 4446 4447 4451 4452 4454 4465
}

normal_winter = {
	2738 2753 2291 2717 2725 1136 107 1000 992 2689 947 2697 588 1124 995 486 2079 960 1998 572 1040 2195
    2145 2161 2168 2180 134 674 2281 1148 1154 2279 1156 585 952 2311 4112 4111 114 297 2433 1748 1073 2437
    1021 2110 2187 1993 110 1235 2142 703 2144 685 1821 2140 108 1110 2481 2369 1966 470 2228 448 2165 1987
    1094 1833 1086 2146 723 185 2990 2567 2112 2153 472 1815 454 453 2229 2748 2016 2694 2445 890 346 1105
    693 2172 168 190 2171 2151 686 1125 442 513 739 510 2569 2891 982 2021 770 2741 1072 1865 1044 102 197
    2239 2276 2275 2989 2245 1139 1117 1116 2248 165 1092 1158 2475 2285 1146 1152 1157 1159 660 289 483 78
    2918 760 2912 755 756 757 2919 2887 2895 2906 2893 2911 776 2903 768 2888 2914 2838 2855 775 633 354 85
    2867 2863 2877 2872 2845 786 2870 2843 2848 2866 2206 416 420 2859 799 2834 2941 2026 537 536 2038 683
    782 2869 2875 2442 781 2861 2844 2847 419 2849 790 2868 386 394 398 391 2345 393 388 387 390 361 64 667
    2940 2207 2883 2211 2202 803 795 2832 794 2946 2878 2837 802 2343 2328 2902 2330 2954 1046 1077 1872 349
    2900 2842 2846 2944 810 452 806 2829 2970 2934 2833 814 2830 384 397 2338 2221 610 2135 1844 67 2935 574
    780 785 2871 2876 778 779 787 2831 804 792 2862 2840 2841 253 2947 360 589 2923 50 234 239 4227 1149 662
    819 2904 820 2943 2660 2816 2663 2815 2826 815 2823 2825 2945 2908 301 2907 2635 834 45 482 295 104 828
    818 817 812 2814 823 2812 2817 826 813 822 816 2821 2822 2416 2009 2199 372 773 250 2884 1811 2809 1140 
    1956 1778 1190 468 2415 308 1755 304 839 242 2197 49 862 838 2632 837 2661 2650 281 4126 71 2158 746 51 
    2625 885 881 2507 2201 2496 889 880 1858 2198 2492 2208 859 2494 2754 369 4114 44 1155 2530 480 928 1055
    2772 1224 2760 2770 1223 4052 1213 2763 1217 2799 4033 2761 2758 2759 61 2323 2807 2806 48 2631 2890 127
    2785 1207 2757 1218 2756 1210 2779 2795 2783 2764 2768 2769 2331 2329 399 198 2242 2065 1015 52 2649 463
    2793 402 2765 2767 43 2790 2789 2313 1091 2958 2641 721 212 852 2794 730 2589 2125 2443 2043 60 345 1794
    540 310 1959 2376 605 274 38 309 606 1961 37 2377 293 1960 296 1752 3001 1772 766 2039 561 553 2427 539
    380 150 2626 2232 2314 2500 850 2623 1035 440 2352 2351 471 2126 554 1968 2517 53 2224 2410 2292 2835 882
    2653 2938 842 412 415 1857 14 13 1874 2315 1129 11 8 1799 1018 4127 2638 233 2096 2060 228 145 2209 2805
    405 2618 2310 2667 12 854 1983 2996 410 857 2309 2643 2621 409 843 406 2666 883 860 861 2657 851 2017 720 
    2497 2417 2642 858 2652 2662 2633 2651 2637 841 2640 2933 241 2967 1039 621 2548 656 2961 2307 2014 709
    831 2857 252 206 221 230 224 1750 2879 2939 240 747 2929 59 626 679 2170 103 358 2325 2044 2081 910 2020
    829 245 2808 249 2804 2811 2931 2803 246 2937 244 247 502 2889 741 2254 2591 4119 1820 2269 632 2665 307
    830 2810 208 2771 216 373 374 1226 2326 2474 357 66 2544 2957 2258 2592 2247 4128 2533 922 2634 845 677
    375 1232 376 2965 2852 1228 251 2851 229 1749 232 207 231 1861 2858 2926 111 2659 2470 83 941 2064 1948
    1978 951 2523 937 227 1851 225 2551 63 1227 6 949 218 2011 1981 3 2255 2257 2267 1137 2261 563 2048 2664
    1760 278 1941 282 2752 2511 2598 477 1777 315 1104 23 1011 77 1938 733 2075 144 542 174 2402 2290 1939
    1979 932 131 2680 120 1744 608 609 1823 89 88 1743 2439 1036 1037 1041 2100 217 549 1763 2461 2392 2476
    938 2547 1070 2733 1879 2552 2542 1061 167 1069 2432 466 1074 1064 2526 964 2681 2553 2543 170 1965 1971
    2436 2672 2524 177 178 2430 2545 950 2991 87 2525 65 2518 959 194 904 2431 905 911 912 913 2555 953 2554
    1845 955 2550 2744 199 2557 184 179 2726 901 195 903 671 1757 353 79 2956 2586 350 1065 534 712 2121 2059
    62 58 1876 1999 1034 2519 2964 122 1933 2727 96 2985 948 119 2455 2534 2516 894 2080 450 933 916 2192 263
    2993 1746 1745 2969 2184 2454 2994 47 2450 209 46 1103 458 2448 86 84 1102 1068 535 2083 1101 846 807 835
    2781 2136 1880 1868 1038 617 631 2955 699 1871 618 620 2473 439 1196 1869 2451 166 2449 2636 2127 988 827
    341 2695 359 2979 1875 105 2981 75 1761 69 2114 1870 1984 97 347 25 16 2413 2070 2167 447 2074 4113 215
    201 965 1830 487 204 76 172 1771 2364 1969 1970 2356 2069 2027 2452 338 2465 1751 28 2375 1832 248 604 18
    706 2419 1962 2302 2304 2658 593 2266 1138 2300 2301 2196 329 2244 961 2282 4120 4118 4131 1762 2685 613
    2293 1114 643 2715 641 2712 978 887 923 1842 2372 664 579 2360 1756 1795 2471
    4235 4236 4237 4238 4239 4240 4241 4242 4243 4244 4245 4246 4247 4248 4249 4250 4251 4252 4253 4254 4255
    4256 4257 4258 4259 4260 4261 4262 4263 4264 4265 4266 4267 4268 4269 4270 4271 4272 4273 4274 4275 4276
    4277 4278 4279 4280 4281 4282 4283 4284 4285 4289 4290 4291 4292
}

severe_winter = {
	800 546 2050 968 1087 2287 1141 213 214 1160 1249 2273 2278 1118 1120 2853 2286 2137 509 2456 187 999
    1130 1115 2241 2260 1131 1119 1123 1134 2246 2259 1873 196 175 211 1142 1239 544 970 914 2047 2084 998
    2270 173 2987 171 2921 1093 840 2175 73 2174 1840 2176 2745 737 186 489 1013 192 1080 1819 505 176 886
    4230 2071 735 987 2147 669 182 2735 1824 180 2556 2513 1198 2237 1150 2280 2284 2288 684 2860 2271 687
    1143 516 1245 515 1219 2225 451 2128 2236 1780 1972 2353 457 459 460 210 946 2148 2836 1003 2594
    2363 577 508 2113 726 2152 1822 4124 957 2801 4072 758 2910 4077 668 4076 288 2905 2414 2820 1112 808
    2588 1144 1992 1793 1788
	#1.25
	4302 4303 4293 4294
}

impassable = {
	1426 1580 2084 2456 2013 725 1240 2185 2561 2271 174 1144 1992 1005 1002
    993 990 2588 998 2743 518 1763 187 1819 505 2402 176 734 569 971 1004 967 687 886
    1003 2594 999 2079 1122 2057 2563 205 101 1010 2942 960 2090 2028 2012 2093 1163
	#1.25
	4481 4482 4483 4484
}
